afrikaans: Ek het jou lief
albanian: Unë të dua
amharic: እወድሻለሁ
arabic: أحبك
armenian: Ես քեզ սիրում եմ
azerbaijani: Mən səni sevirəm
basque: maite zaitut
belarusian: я цябе кахаю
bengali: আমি তোমাকে ভালোবাসি
bosnian: volim te
bulgarian: Обичам те
catalan: T'estimo
cebuano: gihigugma tika
chichewa: ndimakukondani
chinese (simplified): 我爱你
chinese (traditional): 我愛你
corsican: Ti tengu caru
croatian: Volim te
czech: Miluji tě
danish: jeg elsker dig
dutch: ik houd van je
english: I love you
esperanto: mi amas vin
estonian: Ma armastan sind
filipino: Mahal kita
finnish: Minä rakastan sinua
french: Je vous aime
frisian: Ik hâld fan dy
galician: Quérote
georgian: მიყვარხარ
german: Ich liebe dich
greek: Σε αγαπώ
gujarati: હું તને પ્રેમ કરું છુ
haitian creole: Mwen renmen ou
hausa: Ina son ku
hawaiian: Aloha wau iā ʻoe
hebrew: אני אוהב אותך
hindi: मैं आपसे प्यार करती हूँ
hmong: kuv hlub koj
hungarian: Szeretlek
icelandic: ég elska þig
igbo: a hụrụ m gị n'anya
indonesian: aku mencintaimu
irish: Is breá liom tú
italian: ti amo
japanese: 愛してます
javanese: Aku tresna sampeyan
kannada: ನಾನು ನಿನ್ನನ್ನು ಪ್ರೀತಿಸುತ್ತೇನೆ
kazakh: Мен сені жақсы көремін
khmer: ខ្ញុំ​ស្រលាញ់​អ្នក
korean: 사랑해요
kurdish (kurmanji): Ez hej te dikim
kyrgyz: сени сүйөм
lao: ຂ້ອຍ​ຮັກ​ເຈົ້າ
latin: te amo
latvian: Es mīlu Tevi
lithuanian: aš tave myliu
luxembourgish: Ech hunn dech gär
macedonian: Те сакам
malagasy: tiako ianao
malay: saya sayang awak
malayalam: ഞാൻ നിന്നെ സ്നേഹിക്കുന്നു
maltese: inħobbok
maori: Aroha ana ahau ki a koe
marathi: मी तुझ्यावर प्रेम करतो
mongolian: Би чамд хайртай
myanmar (burmese): မင်းကိုချစ်တယ်
nepali: म तिमीलाई माया गर्छु
norwegian: Jeg elsker deg
odia: ମୁଁ ତୁମକୁ ଭଲପାଏ
pashto: زه ستا سره مینه لرم
persian: دوستت دارم
polish: Kocham cię
portuguese: Eu te amo
punjabi: ਮੈਂ ਤੁਹਾਨੂੰ ਪਿਆਰ ਕਰਦਾ ਹਾਂ
romanian: Te iubesc
russian: Я тебя люблю
samoan: oute alofa ia oe
scots gaelic: Tha gaol agam ort
serbian: Волим те
sesotho: kea u rata
shona: Ndinokuda
sindhi: مان توهان سان پيار ٿو ڪيان
sinhala: මම ඔයාට ආදරෙයි
slovak: Ľúbim ťa
slovenian: Ljubim te
somali: waan ku jeclahay
spanish: te amo
sundanese: abdi bogoh ka anjeun
swahili: nakupenda
swedish: jag älskar dig
tajik: Ман туро дӯст медорам
tamil: நான் உன்னை நேசிக்கிறேன்
telugu: నేను నిన్ను ప్రేమిస్తున్నాను
thai: ฉันรักคุณ
turkish: Seni seviyorum
ukrainian: я тебе люблю
urdu: میں تم سے پیار کرتا ہوں
uyghur: مەن سىزنى ياخشى كۆرىمەن
uzbek: Men sizni sevaman
vietnamese: Tôi yêu bạn
welsh: Rwy'n dy garu di
xhosa: ndiyakuthanda
yiddish: איך האב דיר ליב
yoruba: mo nifẹ rẹ
zulu: Ngiyakuthanda
